{
  "levels": ["level_1", "level_2", "level_3"],
  "level_1": [
    [1, 1, 1, 1, 1, 1, 1, 1, 1, 1, 1, 1, 1, 1, 1],
    [1, 0, 0, 0, 0, 0, 0, 0, 0, 0, 0, 0, 0, 0, 1],
    [1, 0, 1, 1, 1, 1, 1, 1, 1, 1, 1, 1, 1, 0, 1],
    [1, 0, 1, 0, 0, 0, 0, 0, 0, 0, 0, 0, 1, 0, 1],
    [1, 0, 1, 0, 1, 1, 1, 1, 1, 1, 1, 0, 1, 0, 1],
    [1, 0, 1, 0, 1, 0, 0, 0, 0, 0, 1, 0, 1, 0, 1],
    [1, 0, 1, 0, 1, 0, 1, 1, 1, 0, 1, 0, 1, 0, 1],
    [1, 0, 1, 0, 1, 0, 1, 0, 1, 0, 1, 0, 1, 0, 1],
    [1, 0, 0, 0, 0, 0, 1, 0, 0, 0, 0, 0, 0, 0, 1],
    [1, 1, 1, 1, 1, 1, 1, 1, 1, 1, 1, 1, 1, 1, 1]
  ],
  "level_2": [
    [1, 1, 1, 1, 1, 1, 1, 1, 1, 1, 1, 1, 1, 1, 1],
    [1, 0, 1, 0, 0, 0, 1, 0, 0, 0, 0, 0, 1, 0, 1],
    [1, 0, 1, 0, 1, 0, 1, 0, 1, 1, 1, 0, 1, 0, 1],
    [1, 0, 1, 0, 1, 0, 0, 0, 1, 0, 0, 0, 1, 0, 1],
    [1, 0, 0, 0, 1, 1, 1, 1, 1, 0, 1, 0, 0, 0, 1],
    [1, 1, 1, 0, 0, 0, 0, 0, 0, 0, 1, 1, 1, 1, 1],
    [1, 0, 0, 0, 1, 1, 1, 1, 1, 0, 0, 0, 0, 0, 1],
    [1, 0, 1, 0, 1, 0, 0, 0, 1, 0, 1, 0, 1, 0, 1],
    [1, 0, 1, 0, 0, 0, 1, 0, 0, 0, 1, 0, 1, 0, 1],
    [1, 1, 1, 1, 1, 1, 1, 1, 1, 1, 1, 1, 1, 1, 1]
  ],
  "level_3": [
    [1, 1, 1, 1, 1, 1, 1, 1, 1, 1, 1, 1, 1, 1, 1],
    [1, 0, 0, 0, 0, 0, 0, 0, 0, 0, 0, 0, 0, 0, 1],
    [1, 1, 0, 1, 1, 1, 1, 0, 1, 1, 1, 1, 0, 1, 1],
    [1, 1, 0, 1, 0, 0, 0, 0, 0, 0, 0, 1, 0, 1, 1],
    [1, 1, 0, 1, 0, 1, 1, 1, 1, 1, 0, 1, 0, 1, 1],
    [1, 1, 0, 0, 0, 1, 0, 0, 0, 1, 0, 0, 0, 1, 1],
    [1, 1, 1, 1, 0, 1, 0, 1, 0, 1, 0, 1, 1, 1, 1],
    [1, 0, 0, 0, 0, 0, 0, 1, 0, 0, 0, 0, 0, 0, 1],
    [1, 0, 1, 1, 1, 1, 1, 1, 1, 1, 1, 1, 1, 0, 1],
    [1, 1, 1, 1, 1, 1, 1, 1, 1, 1, 1, 1, 1, 1, 1]
  ]
}
